8/11/END
WWWIWWWWWWW
W   EE  WPW
W   EE  WDW
WV  EEE WKW
W   EE  W W
W   EE    W
W         W
WWWSWWWWWWW