7/10/Niveau2.txt
WWWWWWWWWW
W E      I
W WWWWWW W
W        W
W WW WWW W
WPVD WD  W
WWWIWWWWWW