7/5/END
WWWWW
WPW W
SKW W
W W W
W W W
W W W
WWWWW