8/11/END
WWWWWWWWWWW
WI  EE  WPW
W   EE  WDW
WV  EEE WKW
W   EE  W W
W   EE    W
W  S      W
WWWWWWWWWWW