10/10/END
WWWWWWWWWW
W W  WE  W
W  W  W WW
WW  W   WW
WWW  WW PW
WVWW WW WW
W       WW
W WWWWW WW
WDWWWWW  W
WIWWWWWWWW
