8/11/Niveau8.txt
WWWWWWWWWWW
W   E  SWIW
W WWWW  WPW
WVW   WKW W
W   WWWWW W
WWW       W
WD  WWWWW W
WWWWWWWWWWW