9/25/END
WWWWWWWWWWWWWWWWWWWWWWWWW
WDWW W               WWWW
W    W W WWWWWWWWWWW   KW
WWWW W W WWWWWWWWWWWWWWWW
W      W W             PI
W WWEW W W WWWWWWW WWWWWW
W WWWW W W         W   VW
W    W W   WWWWWWW   WWWW
WWWSWWWWWWWWWWWWWWWWWWWWW
