10/10/END
WWWWWWWWWW
W W  WE  W
W  W  W WW
WW  W   WW
WWW  WW PW
WVWW WW WW
W       WW
WDWWWWW WW
WIWWWWW  W
WWWWWWWWWW
