10/10/END
WWWWWWWWWW
WI      PW
WW WWWWWWW
WW WD   WW
W  WWWW  S
WKWE EW WW
W WW WW WW
W    W  WW
WWWW   VWW
WWWWWWWWWW
