5/12/END
WWWWWWWWWWWW
WP        DW
W WWWWWWW IW
WV        SW
WWWWWWWWWWWW
