10/10/END
WWWWWWWWWW
WSW WWWWWW
W W W  PIW
W E W WWWW
W W W W WW
W W   W VW
W W W W WW
W   W   WW
WKWDW WWWW
WWWWWWWWWW
