10/10/END
WWWWWWWWWW
WIW   P  W
W  WDWWW W
WW  W    W
WVW  WWW W
W  W   W W
WW WWW   W
WW WWW W W
WW     WEW
WWWWWWWWWW
