10/10/END
WWWWWWWWWW
S W WWWWWW
W W W   PI
W E W WWWW
W W W W WW
W W   W VW
W W W W WW
W   W   WW
WKWDW WWWW
WWWWWWWWWW
