12/13/END
WWWWWWWWWWWWW
WIP         W
WWW W WWW WDW
WKW W   W WWW
W W W W W  EW
W     W W WWW
W WW WW W WVW
WE      W W W
W WWWWWWW   W
W  WWW    WWW
WW     WW  SW
WWWWWWWWWWWWW
