7/5/END
WWWWW
WPW W
W W W
W W W
W W W
WEW W
WWWWW