7/5/END
WWWWW
W W W
W W W
WPW W
WDW W
WVW W
WWWWW