7/5/END
WWWWW
W W W
W W W
WPW W
W W W
WVW W
WWWWW