9/25/Niveau3.txt
WWWWWWWWWWWWWWWWWWWWWWWWW
WDWW W               WWWW
W    W W WWWWWWWWWWW   KW
WWWW W W WWWWWWWWWWWWWWWW
W      W W            PIW
W WWEW W W WWWWWWW WWWWWW
W WWWW W W         W   VW
W   SW W   WWWWWWW   WWWW
WWWWWWWWWWWWWWWWWWWWWWWWW
