7/10/Niveau2.txt
WWWWWWWWWW
W        W
W WWWWWW W
W      I W
W WW WWW W
WPVD WDE W
WWWWWWWWWW