7/5/END
WWWWW
WPW W
S W W
W W W
W W W
W W W
WWWWW